eydhz
  hS
      F 254
hsf
NO ./plop
hSF
plop ploo
EA            ./hello
     1111111111111
   1W1110 0001    
    1   0     1
   111111111111
