1111111111111
111W111000001
1111111111111
