NO             ./srcs/check_files.c
SO ./srcs/check_files.c
WE ./srcs/check_files.c
EA            ./srcs/check_files.c
          
C 225,0, 1 


  F          0,      100     , 0
         1111111111111111111111111
         1000000000110000000000001         
         1011000001110000000000001
         1001000000000000000000001
111111111011000001110000000000001
100000000011000001110111111111111
111101111111110111111001010001
111101111111110111  101010011
110000001101010111111000010001
10000000000000001100000010001
10000000000000001101010010001
11000001110101011111011110N0111
11110111 1110101 101111010001
11111111 1111111 111111111111