NO             ./xpmfiles/northtext.xpm
SO ./xpmfiles/southtext.xpm
WE ./xpmfiles/westtext.xpm
EA            ./xpmfiles/easttext.xpm
          
C 225,0, 1 


  F          0,      100     , 0
         1111111111111111111111111111111
         1000000000110000000000001111111         
         1011000001110000000000001111111
    111111100100000000000000000000111111
1111100W01011000001110000000000001111111
10000000011000001110111111111111
11100000000111110111111001010001
111101111111110111  101010011111
110000001101010111111000010001
10000000000000001100000010001
10000000000000001101010010001
110000011101010111110111100111
11110111 1110101 101111010001
11111111 1111111 111111111111