  
  




  
  
  
  
    1111111111111
 111W1110 0001    
    1   0     1
   1111111111111
