SO ./xpmfiles/we.xpm
NO             ./xpmfiles/ea.xpm
WE ./xpmfiles/westtext.xpm
EA            ./xpmfiles/no.xpm
          
C 77,185,216 


  F          118,      31    , 18
         1111111111111111111111111111111
         1011N00000111000000000001111111
    111111111100000000000000000000111111
    111111100100000000000000000000111111
1111100001010000000000000000000001111111
100000000110000000000000000000000000011111111
11100000000111110111111001010001
111101111111110111  101010011111
110000001101010111111000010001
10000000000000001100000010001
10000000000000001101010010001
110000011101010111110111100111
11110111 1110101 101111010001
11111111 1111111 111111111111