SO ./xpmfiles/westtext.xpm
NO             ./xpmfiles/ea.xpm
WE ./xpmfiles/easttext.xpm
EA            ./xpmfiles/no.xpm
          
C 77,185,216 


  F          118,      31    , 18

  1111111111111111111111111111111111111111111111111111111111111111111111111111111111111111111111
  1110000000000000000000000000000000000000S11111100000000000000000000000000000111111111111111111
  1111111111111111111111111111011111111111011111111111111111111111111111111111111111111111111111
  1111111111111111111111000000000000000000011111110000000000000000000000000000000000000000000011
  1111111111111000000000000000000000000000000001111111111111111111111111111111111000000000111111
  1000000000000011111111101111111111111111000000000000000000000000000000000000000011111111111111
  1111100000011111000000000000000000000111000000000000000000000000000000001110000011111111111111
  1000000000111100000000000111111100000111000000011111000000000001111000000000001111000001111111
  1111111100111100000111100000000000001111000000011111000000000000000000000000000000000000000001
  1111111100111110000000000000000000001111000111111111111111110001111111111111111111111111111111
  1111111100111111111111111111111111111111111111111111111111110001111111111111111111111111111111
  1000000000000000000000000000000000000000000000000000000000000000000000000000000000000000000001
  1000000000000000000000000000000000000000000000000000000000000000000000000000000000000000000001
  1000000000000000000000000000000000000000000000000000000000000000000000000000000000000000000001
  1110000000000000000000000000000000000000011111100000000000000000000000000000111111111111111111
  1111111111111111111111111111011111111111011111111111111111111111111111111111111111111111111111
  1111111111111111111111000000000000000000011111110000000000000000000000000000000000000000000011
  1111111111111000000000000000000000000000000001111111111111111111111111111111111000000000111111
  1000000000000011111111101111111111111111000000000000000000000000000000000000000011111111111111
  1111100000011111000000000000000000000111000000000000000000000000000000001110000011111111111111
  1000000000111100000000000111111100000111000000011111000000000001111000000000001111000001111111
  1111111100111100000111100000000000001111000000011111000000000000000000000000000000000000000001
  1111111100111110000000000000000000001111000111111111111111110001111111111111111111111111111111
  1111111100111111111111111111111111111111111111111111111111110001111111111111111111111111111111
  1111111111111111111111111111111111111111111111111111111111111111111111111111111111111111111111