SO ./xpmfiles/westtext.xpm
NO             ./xpmfiles/ea.xpm
WE ./xpmfiles/easttext.xpm
EA            ./xpmfiles/no.xpm
C 15,15,16
F 28,31,15


         1111111111111111111111111111111
         101100000011100000000N01111111
    11111111110000000000000000000111111
1111111111100100000000000000000000111111
100000000000000011000000100011111111111
10000000000000001101010010001
110000011101010111110111100111
11110111 1110101 101111010001
11111111 1111111 111111111111











